Coming Home
An Interactive Fiction by Geraldo
Release 1 / Serial number 210111 / Inform 7 build 6M62 (I6/v6.33 lib 6/12N) SD

Porch
The porche is not very large but has a very beautiful garden. The main door leads inside the house

You can see Main door, an old box (in which are Main key, candle and string), Wooden chair and bucket (empty) here.

>sit on the wooden chair
You feel confortable

>stand up
You get off Wooden chair.

Porch
You can see Main door, Main key, Wooden chair, Old box (in which are candle and string) and bucket (empty) here.

* * *

Coming Home
An Interactive Fiction by Geraldo
Release 1 / Serial number 210111 / Inform 7 build 6M62 (I6/v6.33 lib 6/12N) SD

Porch
The porche is not very large but has a very beautiful garden. The main door leads inside the house

You can see Main door, an old box (in which are Main key, candle and string), Wooden chair and bucket (empty) here.

>open the door
It seems to be locked.

* * *

Coming Home
An Interactive Fiction by Geraldo
Release 1 / Serial number 210111 / Inform 7 build 6M62 (I6/v6.33 lib 6/12N) SD

Porch
The porche is not very large but has a very beautiful garden. The main door leads inside the house

You can see Main door, an old box (in which are Main key, candle and string), Wooden chair and bucket (empty) here.

>take the key
A chill runs up your spine
Taken.

>open the door
It seems to be locked.

>unlock the door
(with Main key)
You unlock Main door.

>open the door
You open Main door.

>enter the door
Hall
You can see a big door made of wood that leads to inside the house.

* * *

>take the key
A chill runs up your spine
Taken.

>unlock the door
(with Main key)
You unlock Main door.

>enter the door
(first opening Main door)

Hall
You can see Main door here.

>show
(yourself Main key)
You see nothing special about Main key.

* * *

Coming Home
An Interactive Fiction by Geraldo
Release 1 / Serial number 210111 / Inform 7 build 6M62 (I6/v6.33 lib 6/12N) SD

Porch
The porche is not very large but has a very beautiful garden. The main door leads inside the house

You can see Main door, an old box (in which are Main key, candle and string), Wooden chair and bucket (empty) here.

>take key
A chill runs up your spine
Taken.

>unlok door
That's not a verb I recognise.

>unlock door
(with Main key)
You unlock Main door.

>enter the door
(first opening Main door)

Hall
You can see Main door here.

* * *

>take key
A chill runs up your spine
Taken.

>unlock door
(with Main key)
You unlock Main door.

>enter door
(first opening Main door)

Hall
You are in an empty hall. There is a stair that leads to the second door. You can see open doors on south and east, leading to other rooms.

Max, who is a very thin and midium-aged man dressed as a buttler, is standing in front of you. As soon as he sees you, he says "Hello and welcome, sir, we've missed you" 

You can also see Main door here.

>enter living room
You can't see any such thing.

>where
That's not a verb I recognise.

>show
(yourself Main key)
You see nothing special about Main key.

>show door
(to yourself)
(first taking Main door)
That's fixed in place.

>try doors
That's not a verb I recognise.

>map
That's not a verb I recognise.

* * *

>enter door
(first opening Main door)

Hall
You are in an empty hall. There is a stair that leads to the second door. You can see open doors on south and east, leading to other rooms.

Max, who is a very thin and midium-aged man dressed as a buttler, is standing in front of you. As soon as he sees you, he says "Hello and welcome, sir, we've missed you" 

You can also see Main door here.

>north
Living Room
The living room is huge and clean, but it doesn't seem to have too much things

>south
Hall
You can see Main door here.

>west
You can't go that way.

>above
That's not a verb I recognise.

>up
Upper Hall

>down
Hall
You can see Main door here.

* * *

>enter door
(first opening Main door)

Hall
You are in an empty hall. There is a stair that leads to the second door. You can see open doors on south and east, leading to other rooms.

Max, who is a very thin and midium-aged man dressed as a buttler, is standing in front of you. As soon as he sees you, he says "Hello and welcome, sir, we've missed you" 

You can also see Main door here.

>talk to max
That's not a verb I recognise.

>takl
That's not a verb I recognise.

>talk
That's not a verb I recognise.

>ask Max about the house
There is no reply.

* * *

>enter door
(first opening Main door)

Hall
You are in an empty hall. There is a stair that leads to the second door. You can see open doors on south and east, leading to other rooms.

Max, who is a very thin and midium-aged man dressed as a buttler, is standing in front of you. As soon as he sees you, he says "Hello and welcome, sir, we've missed you" 

You can also see Main door here.

>ask max about miss
Max just answered you with "Yes, we've missed you"

* * *

Coming Home
An Interactive Fiction by Geraldo
Release 1 / Serial number 210111 / Inform 7 build 6M62 (I6/v6.33 lib 6/12N) SD

Porch
The porche is not very large but has a very beautiful garden. The main door leads inside the house

You can see Main door, an old box (in which are Main key, candle and string), Wooden chair and bucket (empty) here.

>go to the hall
You can't see any such thing.

>take key
A chill runs up your spine
Taken.

* * *

>unlock door
(with Main key)
You unlock Main door.

>enter door
(first opening Main door)

Hall
a door that seams dirty

You can also see Main door here.

>go to Living Room
You can't see any such thing.

>show north
You can't see any such thing.

>see notth
That's not a verb I recognise.

>north
Living Room
The living room is huge and clean, but it doesn't seem to have too much things

>west
Garage

>east
Living Room
The living room is huge and clean, but it doesn't seem to have too much things

* * *

Coming Home
An Interactive Fiction by Geraldo
Release 1 / Serial number 210111 / Inform 7 build 6M62 (I6/v6.33 lib 6/12N) SD

Porch
The porche is not very large but has a very beautiful garden. The main door leads inside the house

You can see Main door, an old box (in which are Main key, candle and string), Wooden chair and bucket (empty) here.

>sit on the chair
You feel confortable

>take the bucket
Taken.

>take the candle
Taken.

>take the string
Taken.

>put the string in the bucket
You put string into bucket.

>put the candle in the bucket
You put candle into bucket.

>get the key
A chill runs up your spine
Taken.

>open the door
It seems to be locked.

>open the door with keey
You can't see any such thing.

>open the door with key
You unlock Main door.

>open the door
You open Main door.

>enter the door
You can't sit in a occupied chair

>get up
You get off Wooden chair.

Porch
The porche is not very large but has a very beautiful garden. The main door leads inside the house

You can see Main door, an old box (empty) and Wooden chair here.

>enter the door
Hall
You are in an empty hall. There is a stair that leads to the second door. You can see open doors on south and east, leading to other rooms.

Max, who is a very thin and midium-aged man dressed as a buttler, is standing in front of you. As soon as he sees you, he says "Hello and welcome, sir, we've missed you" 

You can also see Main door here.

>hi max
That's not a verb I recognise.

>tell "hi max" to max
You can't see any such thing.

>tell hi max to max
You can't see any such thing.

>tell hi to max
You can't see any such thing.

>ask max about the weather
There is no reply.

>ask max about his age
There is no reply.

>hang max
That's not a verb I recognise.

>ask max about the house
There is no reply.

>ask max about house
Max answers "This is your house, sir. I'm sure you are familiar to it"

>enter the left door
You can't see any such thing.

>west
You can't go that way.

>east
Lavabo

>come back
That's not a verb I recognise.

>west
Hall
You are in an empty hall. There is a stair that leads to the second door. You can see open doors on south and east, leading to other rooms.

Max, who is a very thin and midium-aged man dressed as a buttler, is standing in front of you. As soon as he sees you, he says "Hello and welcome, sir, we've missed you" 

You can also see Main door here.

>south
Porch
The porche is not very large but has a very beautiful garden. The main door leads inside the house

You can see Main door, an old box (empty) and Wooden chair here.

>north
Hall
You are in an empty hall. There is a stair that leads to the second door. You can see open doors on south and east, leading to other rooms.

Max, who is a very thin and midium-aged man dressed as a buttler, is standing in front of you. As soon as he sees you, he says "Hello and welcome, sir, we've missed you" 

You can also see Main door here.

>north
Living Room
The living room is huge and clean, but it doesn't seem to have too much things

* * *

>east
Living Room
The living room is huge and clean, but it doesn't seem to have too much things

>east
Home Office

>west
Living Room
The living room is huge and clean, but it doesn't seem to have too much things

>north
Dining Room

>east
You can't go that way.

>west
Kitchen

>get knife
You can't see any such thing.

* * *

Coming Home
An Interactive Fiction by Geraldo
Release 1 / Serial number 210111 / Inform 7 build 6M62 (I6/v6.33 lib 6/12N) SD

Porch
The porche is not very large but has a very beautiful garden. The main door leads inside the house

You can see Main door, an old box (in which are Main key, candle and string), Wooden chair and bucket (empty) here.

>get the key
A chill runs up your spine
Taken.

>unlock the door
(with Main key)
You unlock Main door.

>enter the door
(first opening Main door)

Hall
You are in an empty hall. There is a stair that leads to the second door. You can see open doors on south and east, leading to other rooms.

Max, who is a very thin and midium-aged man dressed as a buttler, is standing in front of you. As soon as he sees you, he says "Hello and welcome, sir, we've missed you" 

You can also see Main door here.

>kill max
Now Max is dead

>kill max
Now Max is dead

* * *

Coming Home
An Interactive Fiction by Geraldo
Release 1 / Serial number 210111 / Inform 7 build 6M62 (I6/v6.33 lib 6/12N) SD

Porch
The porche is not very large but has a very beautiful garden. The main door leads inside the house

You can see Main door, an old box (in which are Main key, candle and string), Wooden chair and bucket (empty) here.

>take all
old box: Taken.
bucket: Taken.
Main key: A chill runs up your spine
Taken.
candle: Taken.
string: Taken.

>unlock de door
You can't see any such thing.

>open the door
It seems to be locked.

>enter the door
(first opening Main door)
It seems to be locked.

>unlock dthe door
You can't see any such thing.

>unlock the door
What do you want to unlock Main door with?

>unlock the door with key
You unlock Main door.

>enter the door
(first opening Main door)

Hall
You are in an empty hall. There is a stair that leads to the second door. You can see open doors on south and east, leading to other rooms.

Max, who is a very thin and midium-aged man dressed as a buttler, is standing in front of you. As soon as he sees you, he says "Hello and welcome, sir, we've missed you" 

You can also see Main door here.

>ask max about the house
There is no reply.

>ask Max about the house
There is no reply.

>ask Max about house
Max answers "This is your house, sir. I'm sure you are familiar to it"

>ask Max about miss
There is no reply.

>ask Max about him
Max just answers you with "Yes, we've missed you"

>ask Max about me
Max looks at you with concern. He says "I believe you should rest sir, you don't seem well. The bedroom is upstairs"

>up
Upper Hall

>west
Small Bedroom

>east
Upper Hall

>east
Medium Bedroom

>west
Upper Hall

>n
Large Bedroom
This seems to be the bed room of the owner of the house. There is some .

>s
Upper Hall

>down
Hall
You are in an empty hall. There is a stair that leads to the second door. You can see open doors on south and east, leading to other rooms.

Max, who is a very thin and midium-aged man dressed as a buttler, is standing in front of you. As soon as he sees you, he says "Hello and welcome, sir, we've missed you" 

You can also see Main door here.

>kill Max
Are you quite sure you want to kill Max?

>yes
Now Max is dead

>ask Max about him
Max just answers you with "Yes, we've missed you"

* * *

>take all
old box: Taken.
bucket: Taken.
Main key: A chill runs up your spine
Taken.
candle: Taken.
string: Taken.

>unlock the door
What do you want to unlock Main door with?

* * *

>unlock the door with key
You unlock Main door.

>enter door
(first opening Main door)

Hall
You are in an empty hall. There is a stair that leads to the second door. You can see doors on north and east, leading to other rooms.

Max, who is a very thin and midium-aged man dressed as a buttler, is standing in front of you. As soon as he sees you, he says "Hello and welcome, sir, we've missed you" 

You can also see Main door here.

>n
Living Room
The living room is huge and clean

You can see a red couch here.